{
  "warehouse": {
    "dimensions": {
      "width": 10,
      "height": 8
    },
    "entrance": {"x": 2, "y": 0},
    "exit": {"x": 9, "y": 5},
    "obstacles": [
      {"x": 2, "y": 3},
      {"x": 5, "y": 5},
      {"x": 4, "y": 1},
      {"x": 5 ,"y": 6}
    ],
    "partitions": [
      {"x": 0, "y": 0},
      {"x": 0, "y": 1},
      {"x": 0, "y": 2},
      {"x": 0, "y": 3},
      {"x": 0, "y": 4},
      {"x": 0, "y": 5},
      {"x": 0, "y": 6},
      {"x": 0, "y": 7},
      {"x": 9, "y": 0},
      {"x": 9, "y": 1},
      {"x": 9, "y": 2},
      {"x": 9, "y": 3},
      {"x": 9, "y": 4},
      {"x": 9, "y": 5},
      {"x": 9, "y": 6},
      {"x": 9, "y": 7},
      {"x": 1, "y": 0},
      {"x": 2, "y": 0},
      {"x": 3, "y": 0},
      {"x": 4, "y": 0},
      {"x": 5, "y": 0},
      {"x": 6, "y": 0},
      {"x": 7, "y": 0},
      {"x": 8, "y": 0},
      {"x": 1, "y": 7},
      {"x": 2, "y": 7},
      {"x": 3, "y": 7},
      {"x": 4, "y": 7},
      {"x": 5, "y": 7},
      {"x": 6, "y": 7},
      {"x": 7, "y": 7},
      {"x": 8, "y": 7}
    ],
    "boxes": [
      {"id": 1, "position": {"x": 3, "y": 3}},
      {"id": 2, "position": {"x": 4, "y": 5}},
      {"id": 3, "position": {"x": 6, "y": 3}}
    ]
  }
}
